#S ##### #S ###
       # ## #  
  ## #   #    #
#  S####   ####
   #S    ###  #
## #### ##   ##
   ### M  #####
 #S S## # ##  #
 ## #   #  S###
###  #### #####
### ##S#  ##S #
#S  #  # ##  ##
S ### #     ###
# ##  ## ## ###
#S   #    #   G
